#General

tagGameDifficultySetting01=普通难度
tagGameDifficultySetting02=老兵难度
tagGameDifficultySetting03=精英难度

tagAutosort=库存自动整理

tagPromptButtonYes=是
tagPromptButtonNo=否
tagPromptButtonOkay=好
tagPromptButtonClose=关闭

tagGraveName=玩家坟墓 ~{%t0}
tagGraveSlainBy=死于{%t0}
tagGraveXPRecovered=回收经验：{%d0}
tagHeroXP=敌方英雄经验{%d0}
tagBossXP=敌方首领经验{%d0}
tagHeroKilled=击杀敌方英雄
tagBossKilled=击杀敌方首领
tagXPAwarded=经验奖励{%d0}

tagUndo=撤销
Chat=聊天:

tagGamePaused=游戏已暂停

#Riftgate

tagRiftgatePersonal=个人传送裂缝
tagRiftgateDestination=目的地
tagRiftgateError01=你 无 法 使 用 这 个 传 送 裂 缝 。 它 由 一 个 不 与 你 同 队 伍 的 玩 家 创 建 。
tagRiftgateDialog01=打 开 一 个 新 传 送 裂 缝 将 会 关 闭 你 现 有 的 。 你 要 继 续 吗 ？
tagRiftGateMapA01=凯恩世界

#Quest

tagQuests=激活的任务
tagQuestLogNameNumber={%t0}（{%d1}）
tagQuestJournalNoQuests=无任务
tagQuestIncentives=动机：
tagQuestObjectives=目标：
tagQuestRewards=奖励：
tagCodexJournalNoNotes=没有条目
tagAccept=接受
tagDecline=拒绝
tagContinue=继续
tagEndConversation=结束对话
tagQuestPrimary=（主要）
tagQuestSecondary=（次要）
tagQuestElite=（精英）
tagQuestAccepted=接受的任务：{^n}“{%t0}”
tagQuestCompleted=已完成任务：{^n}“{%t0}”
tagQuestUpdated=任务更新：{^n}“{%t0}”
tagQuestFailed=任务失败：{^n}“{%t0}"
tagActionGiveMoney={%d0}铁币
tagActionGiveExperience={%d0}经验值
tagActionGiveFaction={%d0} {%t1}势力
tagActionGiveLevel={%d0}等级
tagActionGiveLevels={%d0}等级
tagActionGiveSkillPoint={%d0}技能点
tagActionGiveSkillPoints={%d0}技能点
tagActionGiveAttributePoint={%d0}属性点
tagActionGiveAttributePoints={%d0}属性点
tagConditionHasKilled={%t0}（{%d1}/{%d2}）
tagConditionHasItem={%t0}（{%d1}/{%d2}）
tagQuestRewardWindowTitle=任务完成
tagQuestRewardWindowInterim=任务进度
tagQuestRewardTitle=奖励:
tagQuestRewardMoney={%d0}铁币
tagQuestRewardXP=经验值：{%d0}
tagQuestRewardReputationPositive=+{%d0} {%s1}声望
tagQuestRewardReputationNegative=-{%d0} {%s1}声望
tagQuestRewardAcceptButton=接受

#Faction

tagFaction=势力：{^g}{%s0}
tagFactionStanding=地位：{^g}{%t0}
tagFactionQuestReq=附加任务：{^b}{%+d0}
tagFactionAlone=独立
tagFactionInvisible=不可见
tagFactionGenericMonster=怪物
tagFactionPlayer=玩家
tagFactionSurvivors=魔鬼路口
tagFactionAetherials=虚灵
tagFactionCthonians=冥灵
tagFactionOutlaws=克隆利帮
tagFactionBeasts=野兽
tagFactionUser0=流浪者
tagFactionUser1=中立
tagFactionUser2=霍姆斯特德
tagFactionUser3=科里根矿的自由民
tagFactionUser4=放逐者
tagFactionUser5=死亡守夜人教团
tagFactionUser6=不死族
tagFactionUser7=黑暗军团
tagFactionUser8=Kymon's Chosen
tagFactionUser9=User9
tagFactionUnknown=未知
tagFactionStateEnemy5=复仇
tagFactionStateEnemy4=憎恨
tagFactionStateEnemy3=厌恶
tagFactionStateEnemy2=轻视
tagFactionStateEnemy1=敌对
tagFactionStateNeutral=容忍
tagFactionStateFriend1=认可
tagFactionStateFriend2=友好
tagFactionStateFriend3=信赖
tagFactionStateFriend4=尊敬
tagFactionStateFriend5=敬畏
tagFactionStateNemesis=复仇
tagFactionStateHated=憎恨
tagFactionStateReviled=痛斥
tagFactionStateHostile=敌对
tagFactionStateUnfriendly=不友好
tagFactionStateSuspicious=怀疑
tagFactionStateFriendly=友好
tagFactionStateTrusted=信赖
tagFactionStateHonored=尊敬
tagFactionStateRevered=敬畏

#HUD

tagHUDMenu=菜单按钮
tagHUDAttacks=当前攻击
tagHUDSkills=快捷槽
tagHUD_PotionHealth=愈合药水
tagHUD_PotionEnergy=精神药水

tagPortraitKick=从服务器踢出
tagPortraitTrade=交易
tagPortraitRemove=从队伍中移除
tagPortraitChat=聊天
tagPortraitDisband=解散战宠

tagHUDRoll_Health={%s0} {%d1}/{%d2}
tagHUDRoll_XP={%s0} {%d1} ~ {%s2}{%d3}
tagHUDXP_Current=经验
tagHUDXP_Next=下一等级
tagMaxLevel=已达最高等级
tagSkillRefreshTime=-{%.1f0} {%z1}充能时间
tagSkillRefreshTimeInfinate=100%减少充能时间

tagSkillUnusableLowMana=能量过低
tagSkillUnusableCooldown=技能充能中
tagSkillUnusableConfiguration=技能需要装备

tagHUD_Riftgate=在现实的空间上撕裂一个入口穿梭到任何一个已知的裂缝。
tagHUD_EmptySlot_R=清空快捷槽
tagHUD_EmptySlot_R1=右键分配一个技能。
tagHUD_LeftMouse_R=左键分配
tagHUD_LeftMouse_R1=这是你的主要攻击方式。点击右键来分配一个技能。
tagHUD_RightMouse_R=右键分配
tagHUD_RightMouse_R1=这是你的次要攻击方式。点击右键来分配一个技能。
tagHUD_CompassToggleName=指南针地图开关
tagHUD_CompassToggleDescription=点击更改尺寸或最小化指南针地图。

tagHUD_LeftMouse=左键
tagHUD_RightMouse=右键

tagHUDPortraitLevelUP=升级
tagHUDWeaponSwap=切换武器
tagHUDWeaponSwapRoll=在装备的武器设置中切换。你必须装备有第二套武器。
tagHUDWeaponSwapHelpRoll=在 使 用 武 器 切 换 前 ， 你 必 须 在 人 物 窗 口 的 替 换 武 器 槽 中 装 备 有 第 二 套 武 器 。

tagHUDRiftgateButton=裂缝传送
tagHUDRiftgateButtonRoll=撕 裂 开 一 个 小 传 送 裂 缝 通 道 通 向 任 何 发 现 过 的 传 送 裂 缝 或 者 由 其 他 队 员 创 建 的 传 送 裂 缝 。

tagHUDQuickslot=未分配的快捷槽
tagHUDQuickslotRoll=点击右键来分配技能。
tagHUDQuickslotLM=左键分配
tagHUDQuickslotLMRoll=主要攻击。点击右键分配技能。
tagHUDQuickslotRM=右键分配
tagHUDQuickslotRMRoll=次要攻击。点击右键分配技能
tagHUDQuickslotBarSwap=切换备用快捷槽。

tagHUDButtonCharacter=人物窗口
tagHUDButtonSkills=技能窗口
tagHUDButtonGroup=组队窗口
tagHUDButtonQuest=任务窗口
tagHUDButtonMap=地图窗口
tagHUDButtonChat=聊天窗口
tagHUDButtonHelp=帮助窗口
tagHUDButtonOptions=选项菜单

tagHUDButtonRollCharacter=人物属性，库存，和装备管理。
tagHUDButtonRollSkills=技能类别选择和技能分配。
tagHUDButtonRollGroup=玩家邀请和组队管理。
tagHUDButtonRollQuest=关于任务状态和目标的任务日志细节。
tagHUDButtonRollMap=详细的局部和世界地图。
tagHUDButtonRollChat=在你的游戏中向其他玩家发送信息。
tagHUDButtonRollHelp=使用游戏内置帮助。
tagHUDButtonRollOptions=保存，退出和游戏设置。

#SkillUI

tagSkillUndoClass=撤销职业选择
tagSkillUndoPoints=撤销加点
tagSkillClassSelect=选择职业
tagCurrentLevel=当前等级：{%d0}
tagNextLevel=下一等级：{%d0}
tagSkillClassSelectInfo=选 择 一 个 职 业 {^n}{^n} 一 旦 你 做 出 了 选 择 并 且 退 出 了 技 能 窗 口 ， 你 的 选 择 将 被 永 久 固 定 。
tagSkillReq01=还需要{%d0}点额外点数在{%s1}中。
tagSkillReq01Singular=还需要{%d0}点额外点数在{%s1}中。
tagSkillReq02=还需要{%d0}点额外点数在{%s1}中以及技能{%s2}。
tagSkillReq02Singular=还需要{%d0}点额外点数在{%s1}中以及技能{%s2}。
tagSkillReq03=需要技能{%s1}。
tagSkillPointsRemain={%d0}点剩余点数
tagSkillPointsRemainSingular={%d0}点剩余点数

#Character

tagInventoryBag=物品栏
tagInventoryBagDescription=扩展你的物品栏大小

tagStatsResistanceTitle=抗性
tagStatsResistance01=火焰
tagStatsResistance01Desc=对纵火攻击以及产生火焰或燃烧伤害的法术的抗性。
tagStatsResistance02=闪电
tagStatsResistance02Desc=对来自攻击的电击和冲击波以及造成闪电或电击伤害的法术的抗性。
tagStatsResistance03=冰冷
tagStatsResistance03Desc=对寒冰攻击以及造成冰冷或者霜燃伤害的法术的抗性。
tagStatsResistance04=毒性&酸性
tagStatsResistance04Desc=对造成酸性或中毒伤害的邪毒以及强酸的抗性。
tagStatsResistance05=穿刺
tagStatsResistance05Desc=对造成穿刺伤害的破甲投射物与利刃的抗性。
tagStatsResistance06=流血
tagStatsResistance06Desc=抵抗由撕裂以及流血伤害法术造成的流血效果。
tagStatsResistance07=活力
tagStatsResistance07Desc=对造成生命力损伤和生命力衰减的生命汲取咒语的抗性。
tagStatsResistance08=虚化
tagStatsResistance08Desc=对造成虚化伤害的虚化攻击和法术的抗性。
tagStatsResistance09=眩晕
tagStatsResistance09Desc=减少使你无法反抗的眩晕攻击和技能的持续时间。
tagStatsResistance10=混乱
tagStatsResistance10Desc=对 宇 宙 本 身 的 不 稳 定 能 量 释 放 出 的 混 乱 伤 害 的 抗 性 ， 冥 灵 常 会 使 用 这 些 能 量 。
tagStatsResistance11=击倒
tagStatsResistance11Desc=对被击倒的抗性。
tagStatsResistance12=打断
tagStatsResistance12Desc=对法术和技能的打断效果的抗性。

tagCharStatsTab1Name=主要
tagCharStatsTab2Name=次要
tagCharAttributeTitle=属性
tagCharAttributeName01=灵巧
tagCharAttributeName02=体格
tagCharAttributeName03=精神
tagCharAttributeName04=生命
tagCharAttributeName05=能量

tagCharAttributeDescription01=敏 捷 的 思 维 能 改 进 你 的 战 斗 技 巧 ， 提 升 物 理 、 穿 刺 、 流 血 和 创 伤 伤 害 。 灵 巧 也 会 提 升 你 的 近 战 和 远 程 伤 害 的 击 中 几 率 ， 还 有 暴 击 几 率 。

tagCharAttributeDescription02=锻 炼 体 格 有 力 量 穿 上 更 重 的 装 备 ， 并 且 能 灵 敏 地 躲 开 敌 人 的 攻 击 。 体 格 也 能 提 升 你 承 受 创 伤 的 能 力 并 减 少 被 暴 击 的 机 会 。

tagCharAttributeDescription03=强 大 的 精 神 力 会 提 升 你 体 内 的 能 量 流 动 ， 让 你 经 得 起 使 用 更 强 大 的 附 魔 装 备 所 带 来 的 精 神 负 担 。 精 神 也 会 放 大 魔 法 攻 击 的 伤 害 。

tagCharAttributeDescription04=生 命 衡 量 在 死 之 前 你 能 承 受 多 少 的 痛 楚 和 伤 害 。

tagCharAttributeDescription05=能 量 衡 量 你 承 受 魔 法 能 量 的 精 神 能 力 。 精 神 能 力 越 强 ， 就 会 有 越 多 的 能 量 在 等 待 回 复 之 前 供 你 取 用 。

tagCharBonusHealth=生命值加成：
tagCharBonusEnergy=能量值加成：

tagCharBonusPhysicalDmg=附加物理伤害：
tagCharBonusPierceDmg=附加穿刺伤害：
tagCharBonusMagicalDmg=附加魔法伤害：
tagCharBonusDurDmg=附加持续伤害：

tagCharAttributeIncrement01=每一点提升10点灵巧。
tagCharAttributeIncrement02=每一点提升10点体格。
tagCharAttributeIncrement03=每一点提升10点精神。
tagCharAttributeIncrement04=每一点提升50点生命。
tagCharAttributeIncrement05=每一点提升10点能量。

tagCharStatsOAAlert=攻击能力 {^b}(?)
tagCharStatsOA=攻击能力
tagCharStatsOALast=最后攻击：
tagCharStatsOAHit=击中几率：
tagCharStatsOACrit=暴击几率：
tagCharStatsOADescription=更 强 的 攻 击 能 力 能 提 升 你 近 战 和 远 程 攻 击 击 中 的 机 会 ， 提 升 暴 击 几 率 和 暴 击 伤 害 。 进 攻 能 力 弱 于 敌 人 的 防 御 能 力 会 极 大 地 增 加 你 的 攻 击 未 命 中 几 率 。 进 攻 能 力 受 技 能 、 物 品 和 灵 巧 影 响 。

tagCharStatsDAAlert=防御能力 {^b}(?) 
tagCharStatsDA=防御能力
tagCharStatsDALast=最后受到的攻击来自：
tagCharStatsDAHit=被击中几率：
tagCharStatsDACrit=被暴击几率：
tagCharStatsDADescription=更 强 的 防 御 能 力 能 使 你 更 多 躲 掉 敌 人 的 攻 击 ， 降 低 受 到 暴 击 的 机 会 并 且 减 少 受 到 暴 击 时 的 伤 害 。 防 御 能 力 受 技 能 、 物 品 和 体 格 影 响 。

tagRollFormat01={%s0} {^b}{%d1}
tagRollFormat02={%s0} {^s}{%d1} {^b}+ {%d2}
tagRollFormat03={%s0}     {%+.0f1}%
tagRollFormat04={%s0}  ({^y}{%t1}{^w})
tagRollFormat05={%s0} {^s}+{%.0f1}% {^b}+ {%.0f2}%
tagRollFormat06={%s0} {^b}{%.0f1}%
tagRollFormat07={%s0} {^s}{%.2f1} {^b}+ {%.2f2}
tagRollFormat08={%s0} {^b}{%.2f1}
tagRollFormat09={%s0} {^b}+ {%.1f1}%
tagRollFormat10={%s0} {^b}{%.0f1} - {%.0f2}
tagRollFormat11={%s0} {^b}{%d1} - {%d2}
tagRollFormat12={%s0} {^b}{%.0f1}% - {%.0f2}%
tagRollFormat13={%s0} {^b}{%.1f1}%
tagRollFormat14={%s0} {^b}{%.0f1}
tagRollFormat15={%s0} {^b}+ {%.1f1}% + {%.0f2}
tagFormatPercent={%.0f}%
tagFormatPlusPercent=+{%.0f}%
tagFormatMinusPercent=-{%.0f}%
tagFormatPlus=+{%d0}
tagFormatDash={%d0} - {%d1} 
tagFormatDashPercent={%d0}% - {%d1}%
tagCharPointAvailable={^y}{%d0}{^w}点可用点数
tagCharPointsAvailable={^y}{%d0}{^w}点可用点数
tagCharLevel={%d0}级
tagCharXP=经验值：{%t0}
tagCharLevelAndClass={%d0}级{%t1}

tagCharRollLeftHand=副手：
tagCharRollRightHand=主手：

tagInfoPage=信息：

tagTimePlayedName=游戏时间
tagTimePlayedNumber={%d0}:{%d1}:{%d2}

tagCharHeaderResistance=抗性
tagCharHeaderDefense=防御属性
tagCharHeaderOffense=攻击属性
tagCharHeaderCombat=战斗属性
tagCharHeaderCharacter=人物
tagCharHeaderPhysical=物理
tagCharHeaderMagical=魔法
tagCharHeaderPets=战宠加成
tagCharHeaderDefenseSection=防御
tagCharHeaderRetaliation=反击
tagCharHeaderStats=属性
tagCharHeaderMisc=杂项

tagCharStatsDPS=每秒伤害
tagCharStatsDPSDescription=每秒造成的平均伤害，不考虑敌人防御。

tagCharStatsArmorTotalAlert=护甲等级 {^b}(?)
tagCharStatsArmorTotal=护 甲 等 级
tagCharStatsArmorTotalDescription=护 甲 等 级 越 高 ， 受 到 的 物 理 伤 害 就 越 少 。{^n}{^n}从 技 能 和 非 护 甲 部 位 获 得 的 加 成 将 增 加 至 所 有 护 甲 栏 位 。
tagCharStatsHitArmor=击 中 几 率
tagCharStatsArmorUnprotected=无 护 甲
tagCharStatsArmorNA=N/A
tagCharStatsArmorBonus=奖励：
tagCharStatsArmorHead=头部：
tagCharStatsArmorChest=胸部：
tagCharStatsArmorArms=手臂：
tagCharStatsArmorLegs=腿部：
tagCharStatsArmorJewelry=珠宝：
tagCharStatsArmorFeet=足部：
tagCharStatsArmorWaist=腰部：
tagCharStatsArmorShoulders=肩部：

tagFormulaLearn01=恭喜！你学会了如何锻造：
tagFormulaLearn02={^r}你已学会此设计图。
tagFormulaLearn03={^r}[已经学会]

tagItemCompareEquipped=已装备
tagItemCompareVendor=出售的物品
tagItemCompareInventory=物品栏内物品
tagItemCompareGround=地上的物品


#Char Stats Tab 2 人物属性栏2

#Character 人物
tagCharStatsRunSpeed=奔跑速度
tagCharStatsRunSpeedInfo=人 物 相 对 于 基 础 值 的 奔 跑 速 度 （包 含 整 体 速 度）。
tagCharStatsLifeRegen=生命回复
tagCharStatsLifeRegenInfo=战 斗 中 生 命 回 复 速 度 。 加 成 只 影 响 从 装 备 获 得 的 回 复 速 度 ， 不 影 响 基 本 回 复 速 度 。
tagCharStatsEnergyRegen=能量回复
tagCharStatsEnergyRegenInfo=能 量 回 复 速 度 。 加 成 只 影 响 从 装 备 获 得 的 回 复 速 度 ， 不 影 响 基 本 回 复 速 度 。
tagCharStatsEnergyAbsorption=能量吸收
tagCharStatsEnergyAbsorptionInfo=吸 收 敌 人 攻 击 和 施 法 所 用 能 量 为 你 所 用 的 百 分 数 。
tagCharStatsConstitution=体力加成
tagCharStatsConstitutionInfo=最 大 体 力 值 额 外 加 成 的 百 分 数 。
tagCharStatsExpGainedBonus=经验加成
tagCharStatsExpGainedBonusInfo=杀 死 怪 物 所 得 额 外 经 验 的 百 分 数 。
tagCharStatsLightRadiusBonus=照亮范围奖励
tagCharStatsLightRadiusBonusInfo=照 亮 范 围 额 外 的 百 分 数 。
tagCharStatsAllSkillsBonus=所有技能加成
tagCharStatsAllSkillsBonusInfo=所 有 已 习 得 技 能 的 额 外 加 成
tagCharStatsSoldierSkillsBonus=士兵技能加成
tagCharStatsSoldierSkillsBonusInfo=所 有 士 兵 专 精 中 已 习 得 技 能 的 额 外 加 成 。
tagCharStatsDemoSkillsBonus=爆破者技能加成
tagCharStatsDemoSkillsBonusInfo=所 有 爆 破 者 专 精 中 已 习 得 技 能 的 额 外 加 成 。
tagCharStatsOccuSkillsBonus=术士技能加成
tagCharStatsOccuSkillsBonusInfo=所 有 术 士 专 精 中 已 习 得 技 能 的 额 外 加 成 。
tagCharStatsNightbladeSkillsBonus=夜刃技能加成
tagCharStatsNightbladeSkillsBonusInfo=所 有 夜 刃 专 精 中 已 习 得 技 能 的 额 外 加 成 。
tagCharStatsArcanistSkillsBonus=秘术师技能加成
tagCharStatsArcanistSkillsBonusInfo=所 有 秘 术 师 专 精 中 已 习 得 技 能 的 额 外 加 成 。

#Physical 物理
tagCharStatsAttackSpeed=攻击速度
tagCharStatsAttackSpeedDescription=相 对 于 基 本 攻 速 的 武 器 攻 击 速 度 （ 整 体 攻 速 ） 。
tagCharStatsAvgDmg=伤害范围
tagCharStatsAvgDmgDescription=基 础 攻 击 每 一 击 所 造 成 的 伤 害 值 ， 已 含 加 成 。

tagCharStatsPhysicalAbsDmg=物理伤害
tagCharStatsPhysicalAbsDmgInfo=基 础 攻 击 每 一 击 所 造 成 的 物 理 伤 害 ， 已 含 加 成 。
tagCharStatsPhysicalPercentDmg=物理伤害加成
tagCharStatsPhysicalPercentDmgInfo=所 有 物 理 伤 害 额 外 加 成 的 百 分 数 。

tagCharStatsPierceAbsDmg=穿刺伤害
tagCharStatsPierceAbsDmgInfo=基 础 攻 击 每 一 击 所 造 成 的 穿 刺 伤 害 ， 已 含 加 成 。
tagCharStatsPiercePercentDmg=穿刺伤害加成
tagCharStatsPiercePercentDmgInfo=所 有 穿 刺 伤 害 的 额 外 加 成 的 百 分 数 。

tagCharStatsBleedAbsDmg=流血伤害
tagCharStatsBleedAbsDmgInfo=基础攻击每一击所造成的3秒内每秒流血伤害值，已含加成。
tagCharStatsBleedPercentDmg=流血伤害加成
tagCharStatsBleedPercentDmgInfo=所 有 流 血 伤 害 的 额 外 加 成 的 百 分 数 。
tagCharStatsBleedDuration=流血效果持续时间8
tagCharStatsBleedDurationInfo=你 的 流 血 攻 击 持 续 时 间 的 额 外 加 成 的 百 分 数 ， 每 秒 造 成 的 伤 害 不 会 提 高 。

tagCharStatsInternalTraumaAbsDmg=创伤伤害
tagCharStatsInternalTraumaAbsDmgInfo=基 础 攻 击 每 一 击 所 造 成 的 5 秒 内 每 秒 内 伤 伤 害 值 ， 已 含 加 成 。
tagCharStatsInternalTraumaPercentDmg=创伤伤害加成
tagCharStatsInternalTraumaPercentDmgInfo=所 有 内 伤 伤 害 的 额 外 加 成 的 百 分 数 。
tagCharStatsInternalTraumaDuration=创伤效果持续时间
tagCharStatsInternalTraumaDurationInfo=你 的 内 部 创 伤 攻 击 持 续 时 间 的 额 外 加 成 的 百 分 数 ， 每 秒 造 成 的 伤 害 不 会 提 高 。

tagCharStatsDamageToHealth=生命窃取
tagCharStatsDamageToHealthInfo=武 器 伤 害 用 来 回 复 生 命 的 百 分 数 。

#Magical 魔法
tagCharStatsCastSpeed=施法速度
tagCharStatsCastSpeedInfo=人 物 相 对 于 基 础 值 的 施 法 速 度 （ 包 含 整 体 速 度 ） 。

tagCharStatsCooldownReduction=冷却时间减少
tagCharStatsCooldownReductionInfo=技 能 冷 却 时 间 减 少 的 百 分 数 。

tagCharStatsManaCostReduction=技能的能量消耗减少
tagCharStatsManaCostReductionInfo=减 少 技 能 施 放 所 消 耗 能 量 的 百 分 数 。

tagCharStatsPercentHealthDamage=生命值百分比减少伤害
tagCharStatsPercentHealthDamageInfo=基 础 攻 击 每 一 击 所 造 成 的 计 算 当 前 生 命 值 百 分 比 的 伤 害 ， 已 含 加 成 。

tagCharStatsFireAbsDmg=火焰伤害
tagCharStatsFireAbsDmgInfo=基 础 攻 击 每 一 击 造 成 的 火 焰 伤 害 ， 已 含 加 成 。
tagCharStatsFirePercentDmg=火焰伤害加成
tagCharStatsFirePercentDmgInfo=所 有 火 焰 伤 害 的 额 外 加 成 的 百 分 数 。

tagCharStatsColdAbsDmg=冰冷伤害
tagCharStatsColdAbsDmgInfo=冰 冷 攻 击 每 一 击 所 造 成 的 穿 刺 伤 害 ， 已 含 加 成 。
tagCharStatsColdPercentDmg=冰冷伤害加成
tagCharStatsColdPercentDmgInfo=所 有 冰 冷 伤 害 的 额 外 加 成 的 百 分 数 。

tagCharStatsLightningAbsDmg=闪电伤害
tagCharStatsLightningAbsDmgInfo=基 础 攻 击 每 一 击 所 造 成 的 闪 电 伤 害 ， 已 含 加 成 。
tagCharStatsLightningPercentDmg=闪电伤害加成
tagCharStatsLightningPercentDmgInfo=所 有 闪 电 伤 害 的 额 外 加 成 的 百 分 数 。

tagCharStatsAcidAbsDmg=酸性伤害
tagCharStatsAcidAbsDmgInfo=基 础 攻 击 每 一 击 所 造 成 的 酸 性 伤 害 ， 已 含 加 成 。
tagCharStatsAcidPercentDmg=酸性伤害加成
tagCharStatsAcidPercentDmgInfo=所 有 酸 性 伤 害 的 额 外 加 成 的 百 分 数 。

tagCharStatsVitalityAbsDmg=活力伤害
tagCharStatsVitalityAbsDmgInfo=基础攻击每一击所造成的活力伤害，已含加成。
tagCharStatsVitalityPercentDmg=活力伤害加成
tagCharStatsVitalityPercentDmgInfo=所有活力伤害的额外加成的百分数。

tagCharStatsAetherAbsDmg=虚化伤害
tagCharStatsAetherAbsDmgInfo=基础攻击每一击所造成的虚化伤害，已含加成。
tagCharStatsAetherPercentDmg=虚化伤害加成
tagCharStatsAetherPercentDmgInfo=所有虚化伤害的额外加成的百分数。

tagCharStatsChaosAbsDmg=混乱伤害
tagCharStatsChaosAbsDmgInfo=基础攻击每一击所造成的混乱伤害值，已含加成。
tagCharStatsChaosPercentDmg=混乱伤害加成
tagCharStatsChaosPercentDmgInfo=所有混乱伤害的额外加成的百分数。

tagCharStatsBurnAbsDmg=燃烧伤害
tagCharStatsBurnAbsDmgInfo=基础攻击每一击所造成的3秒内每秒燃烧伤害值，已含加成。
tagCharStatsBurnPercentDmg=燃烧伤害加成
tagCharStatsBurnPercentDmgInfo=所有燃烧伤害的额外加成的百分数。
tagCharStatsBurnDuration=燃烧效果持续时间
tagCharStatsBurnDurationInfo=你 的 燃 烧 伤 害 持 续 时 间 的 额 外 加 成 的 百 分 数 ， 每 秒 造 成 的 伤 害 不 会 提 高 。

tagCharStatsColdburnAbsDmg=霜燃伤害
tagCharStatsColdburnAbsDmgInfo=基础攻击每一击所造成的3秒内每秒霜燃伤害值，已含加成。
tagCharStatsColdburnPercentDmg=霜燃伤害加成
tagCharStatsColdburnPercentDmgInfo=所有霜燃伤害的额外加成的百分数。
tagCharStatsColdburnDuration=霜燃效果持续时间
tagCharStatsColdburnDurationInfo=你的霜燃伤害持续时间的额外加成的百分数，每秒造成的伤害不会提高。

tagCharStatsElectrocuteAbsDmg=电击伤害
tagCharStatsElectrocuteAbsDmgInfo=基础攻击每一击所造成的3秒内每秒电击伤害值，已含加成。
tagCharStatsElectrocutePercentDmg=电击伤害加成
tagCharStatsElectrocutePercentDmgInfo=所有电击伤害的额外加成的百分数。
tagCharStatsElectrocuteDuration=电击效果持续时间
tagCharStatsElectrocuteDurationInfo=你的电击伤害持续时间的额外加成的百分数，每秒造成的伤害不会提高。

tagCharStatsPoisonAbsDmg=毒素伤害
tagCharStatsPoisonAbsDmgInfo=基础攻击每一击所造成的5秒内每秒毒素伤害值，已含加成。
tagCharStatsPoisonPercentDmg=毒素伤害加成
tagCharStatsPoisonPercentDmgInfo=所有毒素伤害的额外加成的百分数。
tagCharStatsPoisonDuration=毒素效果持续时间
tagCharStatsPoisonDurationInfo=你的毒素伤害持续时间的额外加成的百分数，每秒造成的伤害不会提高。

tagCharStatsVitalityDecayAbsDmg=活力衰减伤害
tagCharStatsVitalityDecayAbsDmgInfo=基础攻击每一击所造成的3秒内每秒活力衰减伤害值，已含加成。
tagCharStatsVitalityDecayPercentDmg=活力衰减伤害加成
tagCharStatsVitalityDecayPercentDmgInfo=所有活力衰减伤害的额外加成的百分数。
tagCharStatsVitalityDecayDuration=活力衰减效果持续时间
tagCharStatsVitalityDecayDurationInfo=你的活力衰减伤害持续时间的额外加成的百分数，每秒造成的伤害不会提高。

#Pets
tagCharStatsPetHealth=战宠生命加成
tagCharStatsPetHealthInfo=你的战宠和召唤物的生命加成的百分数。

tagCharStatsPetDamage=战宠伤害加成
tagCharStatsPetDamageInfo=你的战宠和召唤物所造成的伤害加成的百分数。

tagCharStatsPetAttackSpeed=战宠攻速加成
tagCharStatsPetAttackSpeedInfo=你的战宠和召唤物的攻击速度加成的百分数。

tagCharStatsPetCastSpeed=战宠施法速度加成
tagCharStatsPetCastSpeednfo=你的战宠和召唤物的施法速度加成的百分数。

tagCharStatsPetRunSpeed=战宠移动速度加成
tagCharStatsPetRunSpeednfo=你的战宠和召唤物的移动速度加成的百分数。

tagCharStatsPetOA=攻击能力加成
tagCharStatsPetOAInfo=你的战宠和召唤物的攻击能力加成的百分数。

tagCharStatsPetDA=战宠防御能力加成
tagCharStatsPetDAInfo=你的战宠和召唤物的防御能力加成的百分数。

#Char Stats Tab 3 人物属性栏3

#Defense 防御
tagCharStatsBlockChance=格挡几率
tagCharStatsBlockChanceDescription=格挡一次攻击的几率。

tagCharStatsBlockAmount=格挡值
tagCharStatsBlockAmountDescription=一次成功格挡的减伤数值。

tagCharStatsBlockRecovery=格挡恢复减少
tagCharStatsBlockRecoveryInfo=格挡恢复所需时间减少的百分数。

tagCharStatsDodgeChance=闪避几率
tagCharStatsDodgeChanceInfo=闪避一次近战攻击的几率，完全无视伤害。

tagCharStatsProjDeflectChance=偏斜几率
tagCharStatsProjDeflectChanceInfo=偏斜一次远程攻击的几率，完全无视伤害。

tagCharStatsPhysicalResist=物理抗性
tagCharStatsPhysicalResistInfo=对直接造成物理伤害的攻击和法术的抗性。

tagCharStatsDisruptionResist=打断施法抗性
tagCharStatsDisruptionResistInfo=对能打断技能释放的攻击和法术的抗性。

tagCharStatsLifeLeechResist=生命吸取抗性
tagCharStatsLifeLeechResistInfo=对生命吸取攻击的抗性。

tagCharStatsEnergyLeechResist=能量吸取抗性
tagCharStatsEnergyLeechResistInfo=对能量吸取的抗性。

tagCharStatsTrapResist=限制移动效果抗性
tagCharStatsTrapResistInfo=对陷阱限制你移动效果的的抗性。

tagCharStatsPetrifyResist=石化效果抗性
tagCharStatsPetrifyResistInfo=对是你失去反抗能力的石化法术的抗性。

tagCharStatsFreezeResist=冰冻效果抗性
tagCharStatsFreezeResistInfo=对使你冻结并失去反抗能力的法术的抗性。

tagCharStatsSleepResist=昏睡效果抗性
tagCharStatsSleepResistInfo=对 使 你 昏 睡 的 法 术 的 抗 性 ， 昏 睡 效 果 会 使 你 在 被 打 醒 之 前 不 能 作 出 任 何 反 应 。

tagCharStatsSlowResist=减速效果抗性
tagCharStatsSlowResistInfo=对所有能减缓你攻击、施法和移动能力的法术的抗性。

#Retaliation 反击
tagCharStatsDamageReflect=反击伤害
tagCharStatsDamageReflectInfo=你所受到的伤害会被反馈给攻击者的比率。

tagCharStatsCurrentLifeReflect=生命反击
tagCharStatsCurrentLifeReflectInfo=无论何时你被攻击，以该比率基于敌人当前生命值实施反击。

tagCharStatsPhysicalRet=物理反击
tagCharStatsPhysicalRetInfo=当你被攻击时对攻击者造成的物理伤害。
tagCharStatsPhysicalPercentRet=物理反击加成
tagCharStatsPhysicalPercentRetInfo=所有物理伤害反击效果加成比率。

tagCharStatsPierceRet=穿刺反击
tagCharStatsPierceRetInfo=当你被攻击时对攻击者造成的穿刺伤害。
tagCharStatsPiercePercentRet=穿刺加成
tagCharStatsPiercePercentRetInfo=所有穿刺伤害反击效果加成比率。

tagCharStatsBleedRet=流血反击
tagCharStatsBleedRetInfo=当你被攻击时对攻击者造成3秒内每秒的流血伤害。
tagCharStatsBleedPercentRet=流血反击加成
tagCharStatsBleedPercentRetInfo=所有流血伤害反击效果加成比率。

tagCharStatsInternalTraumaRet=创伤反击
tagCharStatsInternalTraumaRetInfo=当你被攻击时对攻击者造成5秒内每秒的内伤伤害。
tagCharStatsInternalTraumaPercentRet=创伤反击加成
tagCharStatsInternalTraumaPercentRetInfo=所有内伤伤害反击效果加成比率。

tagCharStatsFireRet=火焰反击
tagCharStatsFireRetInfo=当你被攻击时对攻击者造成火焰伤害。
tagCharStatsFirePercentRet=火焰反击加成
tagCharStatsFirePercentRetInfo=所有火焰伤害反击效果加成比率。

tagCharStatsColdRet=冰冷反击
tagCharStatsColdRetInfo=当你被攻击时对攻击者造成冰冷伤害。
tagCharStatsColdPercentRet=冰冷反击加成
tagCharStatsColdPercentRetInfo=所有冰冷伤害反击效果加成比率。

tagCharStatsLightningRet=闪电反击
tagCharStatsLightningRetInfo=当你被攻击时对攻击者造成闪电伤害。
tagCharStatsLightningPercentRet=闪电反击加成
tagCharStatsLightningPercentRetInfo=所有闪电伤害反击效果加成比率。

tagCharStatsAcidRet=酸性反击
tagCharStatsAcidRetInfo=当你被攻击时对攻击者造成酸性伤害。
tagCharStatsAcidPercentRet=酸性反击加成
tagCharStatsAcidPercentRetInfo=所有酸性伤害反击效果加成比率。

tagCharStatsVitalityRet=活力反击
tagCharStatsVitalityRetInfo=当你被攻击时对攻击者造成活力伤害。
tagCharStatsVitalityPercentRet=活力反击加成
tagCharStatsVitalityPercentRetInfo=所有活力伤害反击效果加成比率。

tagCharStatsAetherRet=虚化反击
tagCharStatsAetherRetInfo=当你被攻击时对攻击者造成虚化伤害。
tagCharStatsAetherPercentRet=虚化加成
tagCharStatsAetherPercentRetInfo=所有虚化伤害反击效果加成比率。

tagCharStatsChaosRet=混乱反击
tagCharStatsChaosRetInfo=当你被攻击时对攻击者造成混乱伤害。
tagCharStatsChaosPercentRet=混乱反击加成
tagCharStatsChaosPercentRetInfo=所有混乱伤害反击效果加成比率。

tagCharStatsBurnRet=燃烧反击
tagCharStatsBurnRetInfo=当你被攻击时对攻击者造成3秒内每秒的燃烧伤害。
tagCharStatsBurnPercentRet=燃烧反击加成
tagCharStatsBurnPercentRetInfo=所有霜燃伤害反击效果加成比率。

tagCharStatsColdburnRet=霜燃反击
tagCharStatsColdburnRetInfo=当你被攻击时对攻击者造成3秒内每秒的霜燃伤害。
tagCharStatsColdburnPercentRet=霜燃反击加成
tagCharStatsColdburnPercentRetInfo=所有霜燃伤害反击效果加成比率。

tagCharStatsElectrocuteRet=电击反击
tagCharStatsElectrocuteRetInfo=当你被攻击时对攻击者造成持续3秒的电击伤害。
tagCharStatsElectrocutePercentRet=电击反击加成
tagCharStatsElectrocutePercentRetInfo=所有电击伤害反击效果加成比率。

tagCharStatsPoisonRet=毒素反击
tagCharStatsPoisonRetInfo=当你被攻击时对攻击者造成5秒内每秒的毒素伤害。
tagCharStatsPoisonPercentRet=毒素反击加成
tagCharStatsPoisonPercentRetInfo=所有毒素伤害反击效果加成比率。

tagCharStatsVitalityDecayRet=活力衰减反击
tagCharStatsVitalityDecayRetInfo=当你被攻击时对攻击者造成3秒内每秒的活力衰减伤害。
tagCharStatsVitalityDecayPercentRet=活力衰减反击加成
tagCharStatsVitalityDecayPercentRetInfo=所有活力衰减伤害反击效果加成比率。

#Stats
tagCharStatsItemLevel=平均物品等级
tagCharStatsItemLevelInfo=你所有装备的平均物品等级。

tagRecordTime=已用时间
tagRecordTimeNumber={%d0}:{%d1}:{%d2}
tagRecordTimeInfo=总游戏时间的天数，小时和分钟数。

tagRecordMonsterKills=怪物击杀
tagRecordMonsterKillsInfo=你的角色击杀的怪物总数。

tagRecordChampionKills=精英击杀
tagRecordChampionKillsInfo=你的角色击杀的敌方英雄和头领数量。

tagRecordHighestMonster=最强力怪物击杀
tagRecordHighestMonsterInfo=你的角色击杀过的最强大的怪物。

tagRecordHighestDamage=造成伤害
tagRecordHighestDamageInfo=你的角色单次造成的最高伤害。

tagRecordHighestDamageTaken=承受伤害
tagRecordHighestDamageTakenInfo=你的角色单次承受的最高伤害。

tagRecordDeath=总死亡次数
tagRecordDeathInfo=你的角色的死亡次数。

tagCharStatsSecondaryResist=次级抗性:

tagCharacterStats=人物状态
tagCharStatsFactionTitle=派系
tagCPercentageValue={%.0f}%

#Vendor

tagVendorTabArtifactA=手工艺制品
tagVendorTabArtifactB=PLACEHOLDER（占位更新留用）
tagVendorTab01A=近战武器
tagVendorTab01B=从 废 弃 的 住 宅 中 、 死 去 多 时 的 人 和 将 死 之 人 的 身 上 搜 集 来 的 格 式 各 样 作 战 武 器 。
tagVendorTab02A=远程武器
tagVendorTab02B=应 有 尽 有 ， 包 括 从 不 匹 配 元 件 拼 接 而 成 的 手 枪 到 加 装 自 动 发 射 装 置 的 旧 十 字 弓 内 的 一 切 装 备 。
tagVendorTab03A=护甲
tagVendorTab03B=由 旧 衣 物 和 金 属 废 料 组 装 而 成 的 护 甲 大 全 ， 有 些 甚 至 是 古 战 场 上 遗 留 的 盔 甲 拼 成 的 。
tagVendorTab04A=饰品与消耗品
tagVendorTab04B=老旧圣物和自制药水都在这儿。
tagVendorTab05A=买回
tagVendorTab05B=改 变 主 意 了 ？ 在 商 人 这 儿 可 以 原 价 买 回 卖 出 的 物 品 。 一 旦 你 离 开 ， 出 售 就 成 交 了 。

tagVendorRolloverName=废品收集商人
tagVendorRolloverDescription=这 些 商 人 向 敢 于 离 开 人 类 据 点 出 去 冒 险 的 人 售 卖 搜 集 来 的 或 是 偷 来 的 货 物 ， 利 用 人 类 的 灾 难 来 牟 利 。 最 好 别 打 听 这 些 货 物 的 出 处 。

MarketCostAffordable={^g}花费{%d0}
MarketCostTooExpensive={^r}花费{%d0} ~ 铁币不足
MarketCostPreviousTransaction={^g}花费{%d0} ~ 原价
MarketCostPreviousTransactionTooExpensive={^r}花费{%d0} ~ 铁币不足
MarketValue={^g}售出价格{%d0}
MarketValuePreviousTransaction={^g}卖回价格{%d0} ~ 购入原价
MarketSalePending=未决定售出
MarketPurchasePending=未决定购买

tagMarketError01=你没有足够的铁币。
tagMarketError02=你的库存没有足够的空间。
tagMarketError03=该物品已经被售出。
tagMarketError04=该物品无法被售出。
CanNotBeSoldHere=这个店主不接受该物品。
Sold=已售出


#Crafting

tagCrafting=合成
tagInventorNamePlate=发明家
tagCraftingComponentCount=这种材料的库存数量。
tagCraftingComponentMissing=目前你的库存中没有这种材料。
tagCraftingWindowTitle=发明家
tagCraftingPanelA=装备改造
tagCraftingPanelB=装备拆解
tagCraftingCost=费用：
tagCraftingBlueprint=设计图
tagCraftingComponent=部件
tagCraftingComponentRequired=原材料：
tagCraftingCombine=组合
tagCraftingDisplayBoxHelp=在 工 作 台 上 放 置 一 张 设 计 图 来 开 始 合 成 装 备 。
tagCraftingBlueprintInfo=铁 匠 可 以 基 于 设 计 图 使 用 各 种 各 样 废 弃 的 材 料 合 成 更 高 级 的 物 品 。
tagCraftingDeviceCost=铁币费用：{%t0}
tagCraftingCreate=合成品：
tagCraftingLearn=[右键学习]
tagCraftingRandom={^E}+ 随 机 属 性 （ 单 个 或 多 个 ）

tagCraftingItemType00= ~ 设备
tagCraftingItemType01= ~ 完整部件
tagCraftingItemType02= ~ 完整补给品
tagCraftingItemType03= ~ 卷轴
tagCraftingItemType04= ~ 装备

tagCraftingConfirmation=你确定要进行合成吗？

tagCraftingDetatchmentInfo=

tagCraftingProductBoxInfo=一旦所需材料均已就位，要锻造的物品就会在这里出现。
tagCraftingProductBoxCompletion=从工作台上取走你刚刚锻造的物品。

tagCraftingInsterComponent=把设计图特定的组作加入到这些空位中。

#Subheadings

tagCraftingAxes=斧
tagCraftingBlunt=钝器
tagCraftingSwords=剑
tagCraftingTwoHandedMelee=双手近战武器

tagCraftingOneHanded=单手远程武器
tagCraftingTwoHanded=双手远程武器

tagCraftingBelts=腰带
tagCraftingHelms=头盔
tagCraftingTorso=胸甲
tagCraftingShoulders=护肩
tagCraftingLegs=腿部
tagCraftingHands=护手
tagCraftingFeet=脚部
tagCraftingOffhands=聚能法器
tagCraftingShields=盾牌

tagCraftingComponents=部件
tagCraftingAccessories=饰品
tagCraftingConsumables=消耗品
tagCraftingMaterials=材料

tagCraftingRelics=圣物

tagDividerTab01=回收
tagDividerRoll01=回 收 装 置 被 用 来 从 物 品 上 分 离 附 加 部 件 。 不 幸 的 是 ， 回 收 工 序 的 不 完 善 会 摧 毁 物 品 或 附 加 部 件 中 的 一 个 ， 不 过 你 可 以 做 出 选 择 。

tagDividerTab02=分解
tagDividerRoll02=分 解 装 置 被 用 来 拆 解 强 力 的 物 品 以 得 到 其 基 本 的 部 分 。
tagDividerRoll02B=分 解 装 置 被 用 来 拆 解 强 力 的 物 品 以 得 到 其 基 本 的 部 分 ， 在 分 解 过 程 中 需 要 大 量 的 能 量 ， 所 以 睿 智 的 发 明 家 使 用 火 药 来 完 成 这 个 过 程 。

tagDividerTab03=修补
tagDividerRoll03=修 补 装 置 用 来 进 行 铸 补 。

tagDividingButtonKeepItem=保留物品
tagDividingBoxInfo=将带有附加部件的物品放入回收器.
tagDividingButtonKeepComponent=保留附加部件
tagDividingKeepItemWarning=选择回收物品将会摧毁附加的部件.
tagDividingKeepComponentWarning=选择回收附加部件将会摧毁物品.
tagDividingCost=回收花费

tagDismantleDynamiteTotal=炸药总数：
tagDismantleCost=拆解消耗：
tagDismantleButton=选择拆解会彻底摧毁该物品。
tagDismantleDestroyItemWarning=选择拆解会彻底摧毁该物品，继续？
tagDismantleDestroyItemComponentWarning=选择拆解会彻底摧毁该物品并保留组件，继续？
tagDismantleBoxInfo=放置一个普通级别以上的物品到工作台。

tagTinkerAetherTotal=虚化水晶总数：
tagTinkerCost=重铸花费：
tagTinkerButton=Choosing to Tinker will reroll the completion bonus on this item. This has a chance to destroy the item!
tagTinkerDestroyItem=Your Item was destroyed! Aw shucks!
tagTinkerBoxInfo=Place a component or relic in the chamber.

#Smuggler

tagStorageRefund=退还存储空间
tagCaravanTitle=走私者
tagCaravanCost=花费：{%d0}
tagCaravanRefund=退还：{%d0}
tagCaravanExpand=扩展仓库
tagCaravanItemStorage=仓库
tagStorageInfo01=仓 库 是 你 的 物 品 栏 的 延 伸 。 右 键 或 者 拖 放 来 在 仓 库 和 物 品 栏 之 间 存 取 物 品 。 存 储 的 物 品 在 游 戏 中 每 个 走 私 者 那 里 都 能 取 用 。
tagTransferCost=转移花费：{%d0}
tagTransferAdd=你确定要将该物品放入共享存储中？
tagTransferInfo01=使 用 走 私 者 来 给 其 他 人 物 转 移 物 品 。 只 需 要 把 物 品 丢 进 去 ， 你 的 所 有 角 色 就 都 能 取 用 了 。
tagCaravanItemTransfer=共享仓库
tagTransferInfo02=将物品放入共享仓库让你的所有人物都能使用。
tagCaravanError01=你没有足够的金钱来转移这件物品。
tagStorageError01=你没有足够的金钱来购买拓展存储空间。
tagTransferError01=你需要{%d0}铁币来购买一个拓展存储空间。
tagTransferPurchase01=花费{%d0}铁币来购买一个拓展存储空间?
tagTransferTab01=Tab 1
tagTransferTab02=Tab 2
tagTransferTab03=Tab 3
tagTransferTab04=Tab 4

#Chat

tagChatSend=发送给……
tagChatCommand01=队伍
tagChatCommand02=所有人
tagChatCommand03=回复
tagChatCommand04=告知
tagChatCommand05=禁言
tagChatCommand06=取消禁言
tagChatBrag=[{%t0}{%t1}{^-}]

#NPC Conversation
tagNpcConversationBusy=那个NPC正在和另一名玩家交谈。

#Maps

tagAerialMapCenteredButton=中央
tagAerialMapZoomText=缩放

tagMapWindowName=本地地图
tagRiftWindowName=裂缝地图
tagWorldMapWindowName=世界地图

tagMapSymbolAOI=POI
tagMapSymbolAOIDesc=一个兴趣点。
tagMapSymbolSmuggler=走私者
tagMapSymbolSmugglerDesc=一个存储你的装备并能在你的角色之间运送装备的不法分子.
tagMapSymbolHero=玩家
tagMapSymbolHeroDesc=你的当前位置.
tagMapSymbolInventor=发明家
tagMapSymbolInventorDesc=一个有从装备上移除附加部件本事的修补匠.
tagMapSymbolMission=任务
tagMapSymbolMissionDesc=当前任务.
tagMapSymbolNPC=NPC
tagMapSymbolNPCDesc=非玩家角色.
tagMapSymbolGroup=Group
tagMapSymbolGroupDesc=你的组员的位置.
tagMapSymbolRespawn=治疗师
tagMapSymbolRespawnDesc=一个在恢复活力与缝合严重创伤方面训练有素的治疗师.
tagMapSymbolRiftgate=裂缝之门
tagMapSymbolRiftgateDesc=一个能够传送你到其他地点的非现实世界空间裂缝.
tagMapSymbolVendor=商贩
tagMapSymbolVendorDesc=一个资源货物的商人.
tagMapSymbolWitch=灵魂向导
tagMapSymbolWitchDesc=一个能够帮助你忘却技能的灵魂人物.
tagMapSymbolShrine=祭坛
tagMapSymbolShrineDesc=祭坛会提供有用的增益。
tagMapSymbolSmith=铁匠
tagMapSymbolSmithDesc=一位技艺精湛能够打造新物品的工匠。

#SystemStatsSkillUI

tagOptionsMenuReturn=回到游戏
tagOptionsMenuSave=保存游戏
tagOptionsMenuExit=回到主菜单
tagOptionsMenuQuit=退出到桌面
tagOptionsMenuOptions=选项菜单
tagOptionsMenuGameSaved=你的游戏已保存
tagOptionsMenuAreUSure=你确定要退出到主菜单吗？
tagInfoTitle=信息
tagInfoButtonYes=是
tagInfoButtonNo=否
tagInfoButtonOk=好
tagGameOver=你死了！

SimpleStringFormat={%s0}
SimpleStringsFormat={%s0} {%s1}
SkillBaseNamesFormat={    %s0}
CostFormat=花费：{%d0}
ManaDisplayFormat=能量{%d0}/{%d1} ({%d2}点预留)
LifeDisplayFormat=生命{%d0}/{%d1}
ExperienceDisplayFormat=当前经验值：{^y}{%d0}{^w} ~ 距离下一级还有：{^y}{%d1}

tagExpDisplayFormat=当前经验值：{^y}{%t0}{^w} ~ 距离下一级还有：{^y}{%t1}

tagCharAttribute01={%+.0f0} {^E}灵巧
tagCharAttribute02={%+.0f0} {^E}体格
tagCharAttribute03={%+.0f0} {^E}精神
tagCharAttribute04={%+.0f0} {^E}生命
tagCharAttribute05={%+.0f0} {^E}能量
tagCharConstitution={%+.0f0} {^E}体力
tagCharLifeRegen={%+.1f0} {^E}每秒生命回复
tagCharManaRegen={%+.1f0} {^E}每秒能量回复

tagCharAttribute01Modifier={%+.0f0}% {^E}灵巧
tagCharAttribute02Modifier={%+.0f0}% {^E}体格
tagCharAttribute03Modifier={%+.0f0}% {^E}精神
tagCharAttribute04Modifier={%+.0f0}% {^E}生命
tagCharAttribute05Modifier={%+.0f0}% {^E}能量
tagCharLifeRegenModifier={^E}生命回复提高 {^H}{%.0f0}%
tagCharConstitutionModifier={%+.0f0}% {^E}体力
tagCharManaRegenModifier={^E}能量回复提高 {^H}{%.0f0}%

tagCharManaLimitReserve={%+.0f0} {^E}预留能量
tagCharManaLimitReserveReduction=-{%.0f0} {^E}预留能量消耗
tagCharManaLimitReserveModifier={+%.0f0}% {^E}预留能量
tagCharManaLimitReserveReductionModifier=-{%.0f0}% {^E}预留能量

tagCharRunSpeed={%+.0f0}% {^E}移动速度
tagCharSpellCastSpeed={%+.0f0}% {^E}施法速度
tagCharAttackSpeed={%+.0f0}% {^E}攻击速度
tagCharTotalSpeedModifier={%+.0f0}% {^E}所有速度
tagCharRunSpeedModifier={%+.0f0}% {^E}移动速度
tagCharSpellCastSpeedModifier={%+.0f0}% {^E}施法速度
tagCharAttackSpeedModifier={%+.0f0}% {^E}攻击速度

tagCharAttribute01R={%+.0f0}-{%.0f1} {^E}灵巧
tagCharAttribute02R={%+.0f0}-{%.0f1} {^E}体格
tagCharAttribute03R={%+.0f0}-{%.0f1} {^E}精神
tagCharAttribute04R={%+.0f0}-{%.0f1} {^E}生命
tagCharAttribute05R={%+.0f0}-{%.0f1} {^E}能量
tagCharLifeRegenR={%+.1f0}-{%.1f1} {^E}每秒生命回复
tagCharManaRegenR={%+.1f0}-{%.1f1} {^E}每秒能量回复
tagCharAttribute01ModifierR={%+.0f0}-{%.0f1}% {^E}灵巧
tagCharAttribute02ModifierR={%+.0f0}-{%.0f1}% {^E}体格
tagCharAttribute03ModifierR={%+.0f0}-{%.0f1}% {^E}精神
tagCharAttribute04ModifierR={%+.0f0}-{%.0f1}% {^E}生命
tagCharAttribute05ModifierR={%+.0f0}-{%.0f1}% {^E}能量
tagCharLifeRegenModifierR={^E}生命回复速度提高 {^H}{%.0f0}-{%.0f1}%
tagCharManaRegenModifierR={^E}能量回复速度提高 {^H}{%.0f0}-{%.0f1}%
tagCharManaLimitReserveR={%+.0f0}-{%.0f1} {^E}预留能量
tagCharManaLimitReserveReductionR=-({%.0f0}-{%.0f1}) {^E}预留能量消耗
tagCharManaLimitReserveModifierR={+%.0f0}-{%.0f1}% {^E}预留能量
tagCharManaLimitReserveReductionModifierR=-({%.0f0}-{%.0f1}%) {^E}预留能量
tagCharRunSpeedR={%+.0f0}-{%.0f1}%{^E} 移动速度
tagCharSpellCastSpeedR={%+.0f0}-{%.0f1}%{^E} 施法速度
tagCharAttackSpeedR={%+.0f0}-{%.0f1}%{^E} 攻击速度
tagCharTotalSpeedModifierR={%+.0f0}-{%.0f1}%{^E} 所有速度
tagCharRunSpeedModifierR={%+.0f0}-{%.0f1}%{^E} 移动速度
tagCharSpellCastSpeedModifierR={%+.0f0}-{%.0f1}%{^E} 施法速度
tagCharAttackSpeedModifierR={%+.0f0}-{%.0f1}%{^E} 攻击速度
tagCharOffensiveAbilityR={%+.0f0}-{%.0f1} {^E}攻击能力
tagCharDefensiveAbilityR={%+.0f0}-{%.0f1} {^E}防御能力
tagCharOffensiveAbilityModifierR={%+.0f0}-{%.0f1}%{^E} 攻击能力
tagCharDefensiveAbilityModifierR={%+.0f0}-{%.0f1}%{^E} 防御能力
tagCharDefensiveBlockRecoveryReductionR=-({%.0f0}-%.0f1})% {^E}格挡恢复时间
tagCharEnergyAbsorptionPercentR={%+.0f0}-{%.0f1}%{^E} 敌人法术能量吸取
tagCharDodgePercentR={%.0f0}-{%.0f1}%{^E} 无视近战攻击几率
tagCharDeflectProjectilesR={%.0f0}-{%.0f1}%{^E} 无视投射物几率
tagCharIncreasedExperienceR={%+.0f0}-{%.0f1}%{^E} 经验获取
tagCharLightRadiusR={%+.0f0}-{%.0f1}%{^E} 光照范围
tagCharItemGlobalReductionR={%.0f0}-{%.0f1}%{^E} 装备物品所需属性减少
tagCharLevelReqReductionR=-({%.0f0}-{%.0f1}) {^E}装备物品所需等级
tagCharArmorStrengthReqReductionR=-({%.0f0}-{%.0f1}%) {^E}装备护甲所需体格
tagCharArmorDexterityReqReductionR=-({%.0f0}--{%.0f1}%) {^E}装备护甲所需灵巧
tagCharArmorIntelligenceReqReductionR=-({%.0f0}-{%.0f1}%) {^E}装备护甲所需精神
tagCharJewelryIntelligenceReqReductionR=-({%.0f0}-{%.0f1}%) {^E}装备饰品所需精神
tagCharJewelryStrengthReqReductionR=-({%.0f0}-{%.0f1}%) {^E}装备饰品所需体格
tagCharJewelryDexterityReqReductionR=-({%.0f0}-{%.0f1}%) {^E}装备饰品所需灵巧
tagCharShieldStrengthReqReductionR=-({%.0f0}-{%.0f1}%) {^E}装备盾牌所需体格
tagCharShieldIntelligenceReqReductionR=-({%.0f0}-{%.0f1}%) {^E}装备盾牌所需精神
tagCharShieldDexterityReqReductionR=-({%.0f0}-{%.0f1}%) {^E}装备盾牌所需灵巧
tagCharMeleeStrengthReqReductionR=-({%.0f0}-{%.0f1}%) {^E}装备近战武器所需体格
tagCharMeleeDexterityReqReductionR=-({%.0f0}-{%.0f1}%) {^E}装备近战武器所需灵巧
tagCharMeleeIntelligenceReqReductionR=-({%.0f0}-{%.0f1}%) {^E}装备近战武器所需精神
tagCharHuntingStrengthReqReductionR=-({%.0f0}-{%.0f1}%) {^E}装备远程武器所需体格
tagCharHuntingDexterityReqReductionR=-({%.0f0}-{%.0f1}%) {^E}装备远程武器所需灵巧
tagCharHuntingIntelligenceReqReductionR=-({%.0f0}-{%.0f1}%) {^E}装备远程武器所需精神
tagCharStaffIntelligenceReqReductionR=-({%.0f0}-{%.0f1}%) {^E}装备法杖所需精神
tagCharStaffStrengthReqReductionR=-({%.0f0}-{%.0f1}%) {^E}装备法杖所需体格
tagCharStaffDexterityReqReductionR=-({%.0f0}-{%.0f1}%) {^E}装备法杖所需灵巧
tagCharWeaponIntelligenceReqReductionR=-({%.0f0}-{%.0f1}%) {^E}装备所有武器所需精神
tagCharWeaponStrengthReqReductionR=-({%.0f0}-{%.0f1}%) {^E}装备所有武器所需体格
tagCharWeaponDexterityReqReductionR=-({%.0f0}-{%.0f1}%) {^E}装备所有武器所需灵巧

SkillManaCostReductionR=-{%.0f0}% {^E}技能能量消耗
SkillCooldownReductionR=+{%.0f0}% {^E}技能冷却时间减少
SkillProjectileSpeedModifierR={%+.0f0}% {^E}提高投射物速度
SkillManaCostReductionModifierR=-{%.0f0}% {^E}技能能量消耗
SkillCooldownReductionModifierR=-{%.0f0}% {^E}技能冷却

tagDamageConversion={%.0f0}% {^E}{%s1}转换为{%s2}
tagDamageRemoval={%.0f0}% {^E}{%s1}减少
tagConversionPhysical=物理伤害
tagConversionElemental=元素伤害
tagConversionCold=冰冷伤害
tagConversionFire=火焰伤害
tagConversionPoison=毒性伤害
tagConversionLightning=闪电伤害
tagConversionLife=活力伤害
tagConversionChaos=混乱伤害
tagConversionAether=虚化伤害
tagConversionStun=眩晕持续时间

tagAttackSpeedNotSet=速度：未设定
tagAttackSpeedVerySlow=速度：非常慢
tagAttackSpeedSlow=速度：慢速
tagAttackSpeedAverage=速度：中等
tagAttackSpeedFast=速度：快速
tagAttackSpeedVeryFast=速度：非常快

tagCharOffensiveAbility={%+.0f0} {^E}攻击能力
tagCharDefensiveAbility={%+.0f0} {^E}防御能力
tagCharOffensiveAbilityModifier={%+.0f0}% {^E}攻击能力
tagCharDefensiveAbilityModifier={%+.0f0}% {^E}防御能力

tagCharDefensiveBlockRecoveryReduction={-%.0f0}% {^E}格挡恢复时间
tagCharEnergyAbsorptionPercent={%+.0f0}% {^E}敌人法术能量吸取
tagCharDodgePercent={%.0f0}% {^E}无视近战攻击几率
tagCharDeflectProjectiles={%.0f0}% {^E}无视投射物几率

tagCharIncreasedExperience={%+.0f0}% {^E}经验获取
tagCharLightRadius={%+.0f0}% {^E}光照范围

tagCharItemGlobalReduction={%.0f0}% {^E}所有装备属性需求减少
tagCharLevelReqReduction=-{%.0f0} {^E}装备物品所需等级
tagCharArmorStrengthReqReduction=-{%.0f0}% {^E}装备护甲所需体格
tagCharArmorDexterityReqReduction=-{%.0f0}% {^E}装备护甲所需灵巧
tagCharArmorIntelligenceReqReduction=-{%.0f0}% {^E}装备护甲所需精神
tagCharJewelryIntelligenceReqReduction=-{%.0f0}% {^E}装备饰品所需精神
tagCharJewelryStrengthReqReduction=-{%.0f0}% {^E}装备饰品所需体格
tagCharJewelryDexterityReqReduction=-{%.0f0}% {^E}装备护甲所需灵巧
tagCharShieldStrengthReqReduction=-{%.0f0}% {^E}装备盾牌所需体格
tagCharShieldIntelligenceReqReduction=-{%.0f0}% {^E}装备近战武器所需精神
tagCharShieldDexterityReqReduction=-{%.0f0}% {^E}装备盾牌所需灵巧
tagCharMeleeStrengthReqReduction=-{%.0f0}% {^E}装备近战武器所需体格
tagCharMeleeDexterityReqReduction=-{%.0f0}% {^E}装备近战武器所需灵巧
tagCharMeleeIntelligenceReqReduction=-{%.0f0}% {^E}装备近战武器所需精神
tagCharHuntingStrengthReqReduction=-{%.0f0}% {^E}装备远程武器所需体格
tagCharHuntingDexterityReqReduction=-{%.0f0}% {^E}装备远程武器所需灵巧
tagCharHuntingIntelligenceReqReduction=-{%.0f0}% {^E}装备远程武器所需精神
tagCharStaffIntelligenceReqReduction=-{%.0f0}% {^E}装备法杖所需精神
tagCharStaffStrengthReqReduction=-{%.0f0}% {^E}装备法杖所需体格
tagCharStaffDexterityReqReduction=-{%.0f0}% {^E}装备法杖所需灵巧
tagCharWeaponIntelligenceReqReduction=-{%.0f0}% {^E}装备所有武器所需精神
tagCharWeaponStrengthReqReduction=-{%.0f0}% {^E}装备所有武器所需体格
tagCharWeaponDexterityReqReduction=-{%.0f0}% {^E}装备所有武器所需灵巧

tagChanceOf={%.1f0}% {^E}{的几率{^H}
tagChanceTo={%.1f0}% {^E}{的几率{^H}

Strength=体格
Dexterity=灵巧
Intelligence=精神
Life=生命
Mana=能量
UnusedPointsText={%d0}可用点数
LifeText={%.0f0}生命
ManaText={%.0f0}能量
StrengthText={%.0f0}体格
DexterityText={%.0f0}灵巧
IntelligenceText={%.0f0}精神
FloatFormat={%.0f0}
Float1Format={%.1f0}
Float2Format={%.2f0}
IntFormat={%d0}
CharacterLevelDescription={%s0} - [{%d1}级]
ObjectIdFormat=({%d0})
SkillLevelFormat={%d0}/{%d1}
ShortManaText=能量{%.0f0}/{%.0f1}/{%.1f2}
ShortLifeText=生命{%.0f0}/{%.0f1}
ShortExperienceText=经验{%d0}/{%d1}
ShortLevel=等级{%d0}
HitFormat={%.0f0}
CriticalHitFormat={%.0f0}
CriticalHitFormatMult={%.0f0}(x{%.1f1})
tagMiss=未命中
tagFumble=失误
tagDodge=闪避
tagBlock=格挡
tagDeflect=偏斜
tagInvulnerable=无敌的
GiveMoneyFormat=+{%d0}铁币
TakeMoneyFormat={%d0}铁币
ExperienceFormat=+{%d0}经验值
FactionFormat=+{%d0} {%s1}声望
LevelUpFormat=升级！
SkillPointFormat={%d0}点技能点数
AttributePointFormat={%d0}点属性点数
MenuName=名字: 
MenuLevel=等级：{%d0}
ItemSkillIncrement={+%d0} {^E}致{%s1}
ItemMasteryIncrement={+%d0} {^E}致{%s1}的所有技能
ItemAllSkillIncrement={+%d0} {^E}致所有技能
ItemBasicAttributeBanner={^w}
ItemBonusAttributeBanner={^b}
tagPerSecond=每秒
tagDPS={%.1g0}伤害每秒

LevelRequirement=玩家等级
ShieldBlockAbsorption={%.0f0}%格挡吸收
ShieldBlockRecoveryTime={%.2f0}格挡恢复
MeetsRequirement=需要{%s0}：{%.0f1}
MeetsRequirementWithReduction=需要{%s0}：{%.0f1} [ {^r%.0f2 ^y- %.0f3}%需求减少]
FailsRequirementWithReduction={^r}需要{%s0: %.0f1} [ {%.0f2 ^y- %.0f3}%需求减少]
FailsRequirement={^r}需要{%s0: %.0f1}
SkillIntFormat={%d0 %s1}
SkillFloatFormat={%.0f0 %s1}
SkillFloat1Format={%.1f0 %s1}
SkillFloat2Format={%.2f0 %s1}
SkillSecondFormat={%.1f0 {^E}秒%s1}
SkillDistanceFormat={%.1f0 {^E}米%s1}
SkillCostFormat={%.1f0 %s1}
SkillPercentFormat={%.0f0% %s1}
SkillNumProjectilesFormat=发射{%d0}枚投射物
SkillWeaponDamageFormat={%.0f0%}{^E}的武器伤害
SkillChargeFactor=每次充能级数
SkillChargeMax={^E}最大充能等级
SkillChargeDuration=每级充能持续时间
SkillChargeFactorMod=每次充能级数增加
SkillChargeMaxMod=最大充能等级
SkillChargeDurationMod=每级充能持续时间增加
SkillChanceWeight={%d0}%{^E}的几率使用
SkillActivationChance={^E}的几率激活
SkillDamageAbsorption={%.0f0}{^E}伤害吸收
SkillDamageAbsorptionPercent={%.0f0}%{^E}伤害吸收
SkillPetLimit={%d0} {^E}召唤限制 
SkillLifeBonus={%+.1f0} {^E}生命回复
SkillManaBonus={%+.1f0} {^E}能量回复
SkillLifePercent={%.1f0}% {^E}生命回复
SkillManaPercent={%.1f0}% {^E}能量回复
SkillLifeBonusAndPercent={%.0f1}% + {%.0f0}{^E}生命回复
SkillManaBonusAndPercent={%.0f1}% + {%.0f0}{^E}能量回复
SkillPetDescriptionHeading={%s0}属性：
tagSkillPetAbilities={%s0}技能：
SkillPetDescriptionNextHeading={%s0}下一等级：
SkillPetDescriptionHealth={%.0f0}{^E}点生命
SkillPetDescriptionMana={%.0f0}{^E}点能量
SkillPetDescriptionDamageMinOnly={%.0f0}点伤害
SkillPetDescriptionDamageMinMax={%.0f0}-{%.0f1}点伤害
tagSkillPetTimeToLive={^E}持续{^H}{%.1f0}秒
tagSkillPrevious=……上一级
tagSkillNext=下一级……
PressToAddUnusedSkillPoints=左键点击以投入未使用的技能点数
PressToAddUnusedDevotionPoints=Left Click to Add Unused Devotion Points
PressToActivateDevotion=Left Click to Activate
PressToAssignDevotion=Left Click to Assign
SkillEnhancement=+{%d0}致所有技能
NoSkillPointsToAdd=没有技能点数来添加
NoDevotionPointsToAdd=No Devotion Points Available
LockedDevotion=Locked
ActiveDevotion=Active
PressToAssignDevotion=Left click to assign.
YouMustIncreaseMasteryLevel=你必须提升专精等级才能投入点数
EnableOneBaseSkill=At Least One Requisite Skill Must Be Enabled
MaxSkillLevelReached=已达到技能最高等级
ActiveMasteriesAllowedReached=已达到允许激活的专精个数
LifeMonitorPercent={^E}激活当生命低于{^H}{%.1f0}%时
FailedSkillDependancy=需要：{%s0} 
ManaCost={^E}能量消耗
ActiveLifeCost={^E}每秒激活生命消耗
ActiveManaCost={^E}每秒激活能量消耗
ActiveDuration=持续时间
TargetRadius=目标区域
TargetAngle={%.0f0}{^E}度攻击范围
TargetNumber=最多作用于{%d0}{^E}个目标
CooldownTime={^E}技能冷却
ExplosionRadius=作用范围
ProjectileLaunchRotation={%.1f0}投射物速度
ProjectileLaunchNumber={%d0}{^E}枚投射物
ProjectileLaunchNumberMod=+{%d0} {^E}枚投射物
ProjectileFragmentsLaunchNumberMinMax={%d0 - %d1}{^E}碎片数
ProjectileFragmentsLaunchNumber={%d0}{^E}碎片数
ProjectilePiercingChance={%.1f0}%的几率{^E}穿过敌人


tagTooltipPetsHeader=战宠
tagTooltipSkillsHeader=授予技能

tagShieldBlockInfo={%.0f0}%的几率格挡{^W}{%.0f1}伤害



SkillManaCostReduction=-{%.0f0}% {^E}技能能量消耗
SkillCooldownReduction=+{%.0f0}% {^E}技能冷却减少
SkillProjectileSpeedModifier={%+.0f0}% {^E}提升投射物速度
SkillManaCostReductionModifier=-{%.0f0}% {^E}技能能量消耗
SkillCooldownReductionModifier=-{%.0f0}% {^E}技能冷却

GlobalChanceOfAllTag={^E}的几率：{^H}
GlobalChanceOfOneTag={^E}的几率触发以下其一效果：{^H}
GlobalPercentChanceOfAllTag={%.1f0}% {^E}的几率：{^H}
GlobalPercentChanceOfOneTag={%.1f0}% {^E}的几率触发以下其一效果：{^H}
tagIndent={   }
tagDamageAbsorptionTitle={^E}伤害吸收：
formatQualifyingDamage={     {^E}%s0}
tagQualifyingDamagePhysical=物理
tagQualifyingDamagePierce=穿刺
tagQualifyingDamageLightning=闪电
tagQualifyingDamageFire=火焰
tagQualifyingDamageCold=冰冷
tagQualifyingDamagePoison=毒素或酸性
tagQualifyingDamageLife=活力伤害
tagQualifyingDamageBleeding=流血
tagQualifyingDamageElemental=元素

DamageSingleFormat={%.0f0}
DamageRangeFormat={%.0f0}-{%.0f1}
DamageInfluenceSingleFormat={%.1f0}
DamageInfluenceRangeFormat={%.1f0}-{%.1f1}
DamageReflexSingleFormat={%.1f0}
DamageReflexRangeFormat={%.1f0}-{%.1f1}
DamageSingleFormatTime= {^E}持续{^H}{%.1f0}{^E}秒
DamageRangeFormatTime= {^E}持续{^H}{%.1f0}-{%.1f1}{^E}秒
DamageFixedSingleFormatTime= {^E}持续{^H}{%.1f0}{^E}秒
DamageFixedRangeFormatTime= {^E}持续{^H}{%.1f0} - {%.1f1} {^E}秒
tagDurationDamageOverTime= {^H}{%.1f1}{^E}秒内造成{%d0}{^E}点伤害
tagDotBleeding=流血
tagDotCold=被冰冻
tagDotFire=受到灼烧
tagDotPoison=中毒
tagDotLightning=遭受电击
tagDotChaos=混乱
tagDotAether=虚化
tagDotLifeLeech=生命吸取

tagSetItems=({%d0})套装
tagSecond={^E}秒
tagSeconds={^E}秒
DamagePerSecond={%.1f0} {^S}Damage Per Second (If Equipped)
DamagePhysicalChance= {^E}点物理伤害
DamageBasePhysical= {^S}点物理伤害
DamageBasePierceRatio={%.0f0}% {^S}护甲穿刺
DamageBasePierceRatioR={%.0f0}-{%.0f1}% {^S}护甲穿刺
DamageBonusPhysical={%t0} {^E}物理伤害
tagDamageBaseFire= {^S}基础火焰伤害
tagDamageBaseLightning= {^S}基础闪电伤害
tagDamageBaseCold= {^S}基础冰冷伤害
tagDamageBaseVitality= {^S}基础活力伤害
tagDamageBasePoison= {^S}基础酸性伤害
DamageCold={%t0} {^E}冰冷伤害
DamageFire={%t0} {^E}火焰伤害
DamageAether={%t0} {^E}虚化伤害
DamageChaos={%t0} {^E}混乱伤害
DamageLife={%t0} {^E}活力伤害
DamageLifeLeech={%t0}% {^E}的攻击伤害转化为生命
DamageLightning={%t0} {^E}闪电伤害
DamageElemental={%t0} {^E}元素伤害
DamageModifierElemental={%+.0f0}% {^E}元素伤害
DamageModifierElementalR={%+.0f0}-{%.0f1}% {^E}元素伤害
DamagePhysical=+{%t0} {^E}物理伤害
DamagePierce={%t0} {^E}穿刺伤害
DamagePoison={%t0} {^E}酸性伤害
DamageKnockdown={^E}击倒目标 {^H}{%t0} {^E}{%z1}
DamageStun={^E}眩晕目标 {^H}{%t0} {^E}{%z1}
DamageFreeze={^E}冻结目标 {^H}{%t0} {^E}{%z1}
DamagePetrify={^E}石化目标 {^H}{%t0} {^E}{%z1}
DamageTrap={^E}固定目标 {^H}{%t0} {^E}{%z1}
DamageTaunt=嘲讽
DamageConvert={^E}控制目标思维 {^H}{%t0} {^E}{%z1}
DamageFear={^E}恐惧目标 {^H}{%t0} {^E}{%z1}
DamageConfusion={^E}迷惑目标 {^H}{%t0} {^E}{%z1}
DamageDisruption={^E}打断目标施法 {^H}{%t0} {^E}{%z1}
DamagePercentCurrentLife={%t0}% {^E}减少敌人当前生命值
DamageManaDrain={%t0}% {^E}燃烧法力
DamageManaBurnRatio={^E}({^H}{%.0f0}% {^E}燃烧法力造成的伤害)
DamageModifierManaBurn={%.0f0}% {^E}燃烧法力加成

DamageDurationAttackSpeed=% {^E}降低敌人攻速
DamageDurationCold= {^E}霜燃攻击
DamageDurationReduced= {^E}防御减少
DamageDurationFire= {^E}燃烧伤害
DamageDurationLife= {^E}活力衰减
DamageDurationLifeLeach= {^E}生命吸取
DamageDurationLightning= {^E}电击伤害
DamageDurationManaLeach= {^E}能量吸取
DamageDurationOffensiveAbility= {^E}目标攻击能力降低
DamageDurationOffensiveReduction= {^E}目标物理伤害降低
DamageDurationDefensiveAbility= {^E}目标防御能力降低
DamageDurationDefensiveReduction= {^E}目标护甲降低
DamageDurationPhysical= {^E}内伤
DamageDurationPoison= {^E}毒素伤害
DamageDurationTotalSpeed=% {^E}减速目标
DamageDurationRunSpeed=% {^E}目标移动速度降低
DamageDurationSpellCastSpeed=% {^E}目标施法速度降低
DamageDurationBleeding= {^E}流血伤害

DamageTotalDamageReductionPercent=% {^E}目标伤害降低
DamageTotalDamageReductionAbsolute= {^E}目标伤害降低
DamageTotalResistanceReductionPercent=% {^E}目标抗性降低
DamagePhysicalReductionPercent=% {^E}Reduced target's Physical Damage
DamageElementalReductionPercent=% {^E}Reduced target's Elemental Damage
DamageTotalResistanceReductionAbsolute= {^E}目标抗性降低
DamageDurationFumble=% {^E}几率目标攻击失误
DamageDurationProjectileFumble=% {^E}几率目标瞄准障碍

DamageModifierPhysical={%+.0f0}% {^E}物理伤害
DamageModifierPhysicalR={%+.0f0}-{%.0f1}% {^E}物理伤害
DamageModifierPierceRatio={%+.0f0}% {^E}护甲穿刺
DamageModifierPierceRatioR={%+.0f0}-{%.0f1}% {^E}护甲穿刺
DamageModifierPierce={%+.0f0}% {^E}穿刺伤害
DamageModifierPierceR={%+.0f0}-{%.0f1}% {^E}穿刺伤害
DamageModifierCold={%+.0f0}% {^E}冰冷伤害
DamageModifierColdR={%+.0f0}-{%.0f1}% {^E}冰冷伤害
DamageModifierFire={%+.0f0}% {^E}火焰伤害
DamageModifierFireR={%+.0f0}-{%.0f1}% {^E}火焰伤害
DamageModifierPoison={%+.0f0}% {^E}酸性伤害
DamageModifierPoisonR={%+.0f0}-{%.0f1}% {^E}酸性伤害
DamageModifierLightning={%+.0f0}% {^E}闪电伤害
DamageModifierLightningR={%+.0f0}-{%.0f1}% {^E}闪电伤害
DamageModifierLife={%+.0f0}% {^E}活力伤害
DamageModifierLifeR={%+.0f0}-{%.0f1}% {^E}活力伤害
DamageModifierStun={%+.0f0}% {^E}眩晕持续时间
DamageModifierStunR={%+.0f0}-{%.0f1}% {^E}眩晕持续时间
DamageModifierChaos={%+.0f0}% {^E}混乱伤害
DamageModifierChaosR={%+.0f0}-{%.0f1}% {^E}混乱攻击
DamageModifierAether={%+.0f0}% {^E}虚化伤害
DamageModifierAetherR={%+.0f0}-{%.0f1}% {^E}虚化伤害
DamageModifierKnockdown={%+.0f0}% {^E}击倒持续时间
DamageModifierKnockdownR={%+.0f0}-{%.0f1}% {^E}击倒持续时间

DamageDurationModifierPhysical={%+.0f0}% {^E}内伤伤害
DamageDurationModifierBleeding={%+.0f0}% {^E}流血伤害
DamageDurationModifierCold={%+.0f0}% {^E}霜燃伤害
DamageDurationModifierFire={%+.0f0}% {^E}燃烧伤害
DamageDurationModifierPoison={%+.0f0}% {^E}毒素伤害
DamageDurationModifierLightning={%+.0f0}% {^E}电击伤害
DamageDurationModifierLife={%+.0f0}% {^E}活力衰减
DamageDurationModifierAttackSpeed={%+.0f0}% {^E}攻击减速
DamageDurationModifierSpellCastSpeed={%+.0f0}% {^E}施法减速
DamageDurationModifierRunSpeed={%+.0f0}% {^E}移动减速
DamageDurationModifierLifeLeach={%+.0f0}% {^E}生命吸取伤害
DamageDurationModifierManaLeach={%+.0f0}% {^E}能量吸取
DamageDurationModifierOffensiveAbility={%+.0f0}% {^E}目标进攻能力降低
DamageDurationModifierDefensiveAbility={%+.0f0}% {^E}目标防御能力降低
DamageDurationModifierOffensiveReduction={%+.0f0}% {^E}目标物理伤害降低
ImprovedTimeFormat={^E}with {^H}{%+.0f0}% {^E}持续时间提升
ImprovedTimeFormatR= {^E}伴随 {^H}{%+.0f0}-{%.0f1}% {^E}持续时间提升
IncreasedDuration={^H}{%+.0f0}% {^E}Increased{%s1} Duration

RetaliationCold={%t0} {^E}冰冷反击
RetaliationFire={%t0} {^E}火焰反击
RetaliationLife={%t0} {^E}活力反击
RetaliationLightning={%t0} {^E}闪电反击
RetaliationElemental={%t0} {^E}元素反击
RetaliationPhysical={%t0} {^E}物理伤害反击
RetaliationPierce={%t0} {^E}穿刺反击
RetaliationPoison={%t0} {^E}瞬间毒素&酸性反击
RetaliationAether={%t0} {^E}虚化反击
RetaliationChaos={%t0} {^E}混乱反击
RetaliationStun={%t0} {^E}{%z1} 眩晕反击
RetaliationFreeze={%t0} {^E}{%z1} 冻结反击
RetaliationPetrify={%t0} {^E}{%z1} 石化反击
RetaliationTrap={%t0} {^E}{%z1} 限制移动反击
RetaliationConvert={%t0} {^E}{%z1} 思维控制反击
RetaliationFear={%t0} {^E}{%z1} 恐惧反击
RetaliationConfusion={%t0} {^E}{%z1} 迷惑反击
RetaliationSleep={%t0} {^E}{%z1} 昏睡反击
RetaliationPercentCurrentLife={^E}反击造成 {^H}{%t0}% {^E}敌人当前生命减少
RetaliationDurationAttackSpeed=% {^E}减慢攻击速度反击
RetaliationDurationCold= {^E}霜燃反击
RetaliationDurationDefensiveAbility= {^E}降低防御能力反击
RetaliationDurationFire= {^E}燃烧反击
RetaliationDurationLife= {^E}活力衰减反击
RetaliationDurationLifeLeach= {^E}生命吸取反击
RetaliationDurationLightning= {^E}电击反击
RetaliationDurationManaLeach= {^E}能量吸取反击
RetaliationDurationOffensiveAbility= {^E}降低攻击能力反击
RetaliationDurationOffensiveReduction= {^E}伤害减少反击
RetaliationDurationPhysical= {^E}内伤反击
RetaliationDurationBleeding= {^E}流血反击
RetaliationDurationPoison= {^E}持续毒素反击
RetaliationDurationRunSpeed=% {^E}减慢移动反击
RetaliationDurationSpellCastSpeed=% {^E}减慢施法反击
RetaliationModifierPhysical={%+.0f0}% {^E}物理伤害反击
RetaliationModifierPierceRatio={%+.0f0}% {^E}穿刺反击
RetaliationModifierPierce={%+.0f0}% {^E}穿刺反击
RetaliationModifierCold={%+.0f0}% {^E}冰冷反击
RetaliationModifierFire={%+.0f0}% {^E}火焰反击
RetaliationModifierPoison={%+.0f0}% {^E}酸性反击
RetaliationModifierLightning={%+.0f0}% {^E}闪电反击
RetaliationModifierAether={%+.0f0}% {^E}虚化反击
RetaliationModifierChaos={%+.0f0}% {^E}混乱反击
RetaliationModifierElemental={%+.0f0}% {^E}元素反击
RetaliationModifierLife={%+.0f0}% {^E}活力伤害反击
RetaliationModifierStun={%+.0f0}% {^E}眩晕反击
RetaliationModifierSleep={%+.0f0}% {^E}昏睡反击
RetaliationDurationModifierPhysical={%+.0f0}% {^E}内伤反击
RetaliationDurationModifierBleeding={%+.0f0}% {^E}流血反击
RetaliationDurationModifierCold={%+.0f0}% {^E}霜燃反击
RetaliationDurationModifierDefensiveAbility={%+.0f0}% {^E}降低防御能力反击
RetaliationDurationModifierFire={%+.0f0}% {^E}燃烧反击
RetaliationDurationModifierLife={%+.0f0}% {^E}活力衰减反击
RetaliationDurationModifierLifeLeach={%+.0f0}% {^E}生命吸取反击
RetaliationDurationModifierLightning={%+.0f0}% {^E}电击反击
RetaliationDurationModifierManaLeach={%+.0f0}% {^E}能量吸取反击
RetaliationDurationModifierOffensiveAbility={%+.0f0}% {^E}降低攻击能力反击
RetaliationDurationModifierOffensiveReduction={%+.0f0}% {^E}降低伤害反击
RetaliationDurationModifierPoison={%+.0f0}% {^E}持续毒素反击

DefenseAbsorptionProtection={%.0f0}护甲
DefenseAbsorptionProtectionR={%.0f0}-{%.0f1}护甲
DefenseAbsorptionProtectionPlus=+{%.0f0} {^E}护甲
DefenseAbsorptionProtectionPlusR=+{%.0f0}-{%.0f1}{^E}护甲
DefenseAbsorptionProtectionBonus=+{%.0f0}{^E}护甲加成
DefenseAbsorptionProtectionBonusR=+{%.0f0}-{%.0f1}{^E}护甲加成
DefensePhysical={%.0f0}%{^E}物理抗性
DefensePhysicalR={%.0f0}-{%.0f1}%{^E}物理抗性
DefensePierce={%.0f0}%{^E}穿刺抗性
DefensePierceR={%.0f0}-{%.0f1}%{^E}穿刺抗性
DefenseElementalResistance={%.0f0}%{^E}元素抗性
DefenseElementalResistanceR={%.0f0}-{%.0f1}%{^E}元素抗性
DefenseCold={%.0f0}%{^E}冰冷抗性
DefenseColdR={%.0f0}-{%.0f1}%{^E}冰冷抗性
DefenseFire={%.0f0}%{^E}火焰抗性
DefenseFireR={%.0f0}-{%.0f1}%{^E}火焰抗性
DefenseAether={%.0f0}%{^E}虚化抗性
DefenseAetherR={%.0f0}-{%.0f1}% ^E}虚化抗性
DefenseChaos={%.0f0}%{^E}混乱抗性
DefenseChaosR={%.0f0}-{%.0f1}%{^E}混乱抗性
DefensePoison={%.0f0}%{^E}毒素&酸性抗性
DefensePoisonR={%.0f0}-{%.0f1}%{^E}毒素&酸性抗性
DefenseLightning={%.0f0}%{^E}闪电抗性
DefenseLightningR={%.0f0}-{%.0f1}%{^E}闪电抗性
DefenseLife={%.0f0}%{^E}活力伤害抗性
DefenseLifeR={%.0f0}-{%.0f1}%{^E}活力伤害抗性
DefenseStun=减少{%.0f0}%{^E}眩晕持续时间
DefenseStunR=减少{%.0f0}-{%.0f1}%{^E}眩晕持续时间
DefenseLifeLeach={%.0f0}%{^E}生命吸取抗性
DefenseLifeLeachR={%.0f0}-{%.0f1}%{^E}生命吸取抗性
DefenseManaLeach={%.0f0}%{^E}能量吸取抗性
DefenseManaLeachR={%.0f0}-{%.0f1}%{^E}能量吸取抗性
DefenseTrap=减少{%.0f0}%{^E}诱捕持续时间
DefenseTrapR=减少{%.0f0}-{%.0f1}%{^E}诱捕持续时间
DefenseFreeze=减少{%.0f0}%{^E}的冻结持续时间
DefenseFreezeR=减少{%.0f0}-{%.0f1}%{^E}冻结持续时间
DefenseKnockdown=减少{%.0f0}%{^E}击倒持续时间
DefenseKnockdownR=减少{%.0f0}-{%.0f1}%{^E}击倒持续时间
DefensePetrify=减少{%.0f0}%{^E}石化持续时间
DefensePetrifyR=减少{%.0f0}-{%.0f1}%{^E}石化持续时间
DefenseTaunt={%.0f0}%{^E}嘲讽防护(仅战宠/诱捕)
DefenseConvert=减少{%.0f0}%{^E}思维控制持续时间(仅战宠/诱捕)
DefenseFear=减少{%.0f0}%{^E}恐惧持续时间(仅战宠/诱捕)
DefenseConfusion=减少{%.0f0}%{^E}迷惑持续时间(仅战宠/诱捕)
DefenseDisruption={%.0f0}%{^E}技能打断保护
DefensePercentLife={%.0f0}%{^E}活力减少抗性
DefenseBleeding={%.0f0}%{^E}流血抗性
DefenseBlock={%.0f0}{^E}伤害格挡
DefenseReflect={%.0f0}%{^E}伤害反弹
DefensePhysicalDuration=减少{%.0f0}%{^E}物理持续时间
DefenseBleedingDuration=减少{%.0f0}%{^E}流血持续时间
DefenseColdDuration=减少{%.0f0}%{^E}霜燃持续时间
DefenseFireDuration=减少{%.0f0}%{^E}燃烧持续时间
DefensePoisonDuration=减少{%.0f0}%{^E}毒素持续时间
DefenseLightningDuration=减少{%.0f0}%{^E}闪电持续时间
DefenseLifeDuration=减少{%.0f0}%{^E}活力衰减持续时间
DefenseLifeLeachDuration=减少{%.0f0}%{^E}生命吸取持续时间
DefenseManaLeachDuration=减少{%.0f0}%{^E}能量吸取持续时间
DefensePercentCurrentLife={%.0f0}% {^E}生命值百分比减少抗性
DefenseManaBurnRatio={%.0f0}% {^E}法力燃烧抗性
DefenseProtectionModifier={^E}护甲提升{^H}{%.0f0}%
DefenseProtectionModifierR={^E}护甲提升{^H}{%.0f0}-{%.0f1}%
DefenseAbsorptionModifier={^E}护甲吸收提升{^H}{%.0f0}%
DefenseAbsorptionModifierR={^E}护甲吸收提升{^H}{%.0f0}-{%.0f1}%
DefensePhysicalModifier={^E}提高物理抗性{^H}{%.0f0}%
DefensePierceModifier={^E}提高穿刺抗性{^H}{%.0f0}%
DefenseColdModifier={^E}提高冰冷抗性{^H}{%.0f0}%
DefenseFireModifier={^E}提高火焰抗性{^H}{%.0f0}%
DefensePoisonModifier={^E}提高毒素以及酸性抗性{^H}{%.0f0}%
DefenseLightningModifier={^E}提高闪电抗性{^H}{%.0f0}%
DefenseLifeModifier={^E}提高活力抗性{^H}{%.0f0}%
DefenseChaosModifier={^E}提高混乱抗性{^H}{%.0f0}%
DefenseAetherModifier={^E}提高虚化抗性{^H}{%.0f0}%
DefenseStunModifier={^E}提高眩晕抗性{^H}{%.0f0}%
DefenseBlockModifier={^E}提高护盾格挡几率{^H}{%.0f0}%
DefenseBlockAmountModifier={%+.0f0}% {^E}Shield Damage Blocked
DefenseLifeLeachModifier={^E}提高生命吸取抗性{^H}{%.0f0}%
DefenseManaLeachModifier={^E}提高能量吸取抗性{^H}{%.0f0}%
DefensePercentLifeModifier={^E}提高生命比率抗性{^H}{%.0f0}%
DefenseBleedingModifier={^E}提高流血抗性{^H}{%.0f0}%
DefenseElementalModifier={^E}提高元素抗性{^H}{%.0f0}%
DefensePhysicalDurationModifier=减少{%+.0f0}%{^E}创伤持续时间
DefenseBleedingDurationModifier=减少{%+.0f0}%{^E}流血持续时间
DefenseColdDurationModifier=减少{%+.0f0}%{^E}霜燃持续时间
DefenseFireDurationModifier=减少{%+.0f0}%{^E}燃烧持续时间
DefensePoisonDurationModifier=减少{%+.0f0}%{^E}毒素持续时间
DefenseLightningDurationModifier=减少{%+.0f0}%{^E}电击持续时间
DefenseLifeDurationModifier=减少{%+.0f0}%{^E}活力衰减持续时间
DefenseLifeLeachDurationModifier=减少{%+.0f0}%{^E}生命吸取持续时间
DefenseManaLeachDurationModifier=减少{%+.0f0}%{^E}能量吸取持续时间

RacialBonusPercentDamage={%+.0f0}%{^E}的伤害致{%s1}
RacialBonusAbsoluteDamage={%+.0f0}{^E}点伤害致{%s1}
RacialBonusPercentDefense=来自{%s1}的伤害减少{%.0f0}%{^E}
RacialBonusAbsoluteDefense=来自{%s1}的伤害减少{%.0f0}{^E}点
RacialBonusRaceName={%s0}


tagDamageSleep={^E}使目标昏睡{^H}{%t0}{%z1}
tagDamageModifierSleep={%+.0f0}%{^E}昏睡伤害
tagDefenseSleep={%.0f0}%{^E}昏睡抗性
tagDefenseSleepModifier={%+.0f0}%{^E}昏睡抗性
tagDamageModifierTotalDamage={%+.0f0}%{^E}总伤害
tagRetaliationModifierTotalDamage={%+.0f0}%{^E}总反击伤害
tagTotalSpeedResistance={%.0f0}%{^E}减速抗性
tagMindcontrolledMonster=思维控制
tagSparkMaxNumber={^E}影响最多{^H}{%d0}{^E}个目标

tagItemGrantSkill=授予技能:
tagItemSkill=（从物品获得）
tagItemSkillShort=（物品）
tagEffect=效果：
tagSkillGrantEffect=次级效果：

tagInspectTitle=查看
tagInspectOption=查看玩家
tagInspectWarning=该玩家超出查看距离。
tagGroup01=PVP开启
tagGroup02=自动组队开启
tagAutoItemSkill= (从物品获取 - 被动激活)
tagExclusiveSkill=专有技能 - 同一时间只能激活一个专有技能。

tagAutoSort=自动整理
tagAutoComplete=合并完整部件
tagAttributeUndo=撤销

tagQuestItem=任务物品


tagCR_Jewelry=宝石:
tagRelicError=你不能把一个圣物或符咒附到一个史诗或传奇物品上，

tagExperienceDisplayFormat=现有经验：{^y}{%t0}{^w} ~ 到达下一等级还需经验：{^y}{%t1}
tagCXP=经验值：{%t0}
tagDifficulty01=普通难度
tagDifficulty02=史诗难度 
tagDifficulty03=传奇难度
tagGrave01=玩家坟墓 ~ {%t0}
tagGrave02=死于 {%t0}
tagGrave03=经验回收 : {%d0}
tagHeroXPShort={%d0}英雄经验值
tagBossXPShort={%d0}头领经验值
tagBossXPLong01=头领怪物击杀
tagBossXPLong02={%d0}经验获取
tagHeroXPLong01=英雄怪物击杀
tagHeroXPLong02={%d0}经验获取

tagPetBonusNameAllPets=所有战宠加成
tagPetBonusNameOnePet={%s0}战宠加成
tagPetBonusNameTwoPets={%s0}和{%s1}战宠加成
tagPetBonusNameManyPets=战宠加成

TagSpeakerSetup=扬声器设置
TagHeadphoneSpeakers=耳机扬声器
Tag41Speakers=4声道扬声器
Tag51Speakers=5.1声道扬声器
TagKeybind40=使用备用快捷键栏

tagSelectPet1=选择战宠1
tagSelectPet2=选择战宠2
tagSelectPet3=选择战宠3
tagSelectPet4=选择战宠4
tagSelectPet5=选择战宠5
tagSelectAllPets=选择所有战宠
tagPortraitAggressive=设置为攻击状态
tagPortraitNormal=设置为常态
tagPortraitDefensive=设置为防守状态
tagPortraitHireling=查看

tagMove=移动
tagForceMove=强制移动

tagUC_Button=解锁内容
tagUC_Message=请输入你的解锁码来解锁新内容。
tagUC_OK=好
tagUC_Cancel=取消
tagUC_Error=你已经为这个角色解锁过该内容。

tagHotSlotSwap=主副快捷操槽栏切换。
tagHotSlotTitle=备用快捷键栏
tagEmptyHotSlot=清空此快捷键栏按钮。

tagDevotionUnassigned=No Skill

#Multiplayer

tagMPTrade=交易
tagMPGroup=团队
tagMPInGame=游戏内
tagMPCharName=人物名称
tagMPCharLevel=等级
tagMPCharClass=职业
tagMPAdd=添加
tagMPRemove=移除
tagMPMessage=消息
tagMPInvite=邀请
tagMPLeave=离开团队
tagMPBan=封禁
tagMPAvailable=尚未组队玩家
tagMPGroup1=团队1
tagMPGroup2=团队2
tagMPGroup3=团队3
tagMPNoClass=N/A
tagMPInviteMessage={%t0}邀请你加入一个团队。
tagMPInviteError={%t0}已在一个团队中了。
tagMPInviteSend={%t0}已被发送邀请加入你的团队。
tagMPInviteRemove={%t0}已被移出团队。
tagMPMessageJoin={%t0}已加入你的团队。
tagMPMessageLeave={%t0}已离开你的团队。
tagMPMessageDeny={%t0}拒绝了你的邀请。
tagMPMessageBan={%t0}已被从游戏中封禁。
tagMPMessageGameJoin={%t0}已加入游戏。游戏难度等级已根据人数调整。
tagMPMessageGameLeave={%t0} 已离开游戏.
tagMPQuestionBan=你确定要从游戏中封禁{%t0}吗?
tagMPInviteAccept=接受
tagMPInviteDeny=拒绝
tagMPStats=游戏状态
tagMPMapName=地图名：
tagMPServerName=服务器名：
tagMPPing=延迟：
tagMPTime=持续时间：
tagMPServer=服务器名：{%t0}
tagMPIPAddress=IP地址: {%t0}
tagMPPort=端口: {%t0}
tagMPErrorNoTarget=该玩家超出指向距离。
tagTradeError01={%t0}正在与其他玩家交易。
+tagMPNameLevel={%t0} ({%d1})
tagMPClass={%s0}
tagMPLocation={%s0}
tagMPLifeMana={^r}{%d0}/{%d1} {^g}{%d2}/{%d3}
tagTradeError02={%t0}拒绝了你的交易请求。
tagTradeError03={%t0}请求交易。
tagTradeError04=你的库存没有足够的空间来接受这比交易。
tagTradeButton01=交易
tagTradeButton02=取消
tagTradeDistance=那位玩家超出交易距离。
tagChatGroup=队伍
tagChatAll=所有人
tagChatFriends=好友
tagChatReply=回复
tagChatSpeak=与...对话
tagChatError=不存在使用该姓名的玩家。
tagChatMuted={%t0}现在被静音。
tagChatUnmuted={%t0}不再被静音。
tagChatCommandShort01=p
tagChatCommandShort02=a
tagChatCommandShort03=r
tagChatCommandShort04=t
tagChatCommandShort05=m
tagChatCommandShort06=u




